%%%%%%%%%%%%%%%%%%%%%%%%%%%%
%..........................%
%..........................%
%..........................%
%..........................%
%..........................%
%..........................%
%..........................%
%..........................%
%..........................%
%..........................%
%..........................%
%..........................%
%..............G...........%
%..........................%
%..........................%
%..........................%
%..........................%
%..........................%
%..........................%
%..........................%
%..........................%
%..........................%
%..........................%
%..........................%
%.............P............%
%%%%%%%%%%%%%%%%%%%%%%%%%%%%
